######################################
#1                                   #
#                                    #
#                                    #
#                                    #
#                                    #
#                                    #
#                                    #
#                                    #
#                                    #
#                                    #
#                                    #
#                                    #
#                                    #
#                                    #
#                  W                 #
#                                    #
#                                    #
#                                    #
#                                    #
#                                    #
#                                    #
#                                    #
#                                    #
#                                    #
#                                    #
#                                    #
#                                    #
#                                    #
#                                   2#
######################################